44 44
.##.##..##........#.##.#.#.##.#..#....#..###
##..#.##.#.#.###...#..#.##.#.##.#....####..#
####...##.#..###..######...###....##...#####
.#....##..##.#.###.##..#..##.....####...#...
....##.#....#...#.##.##..###.####..#..######
.#..###...####....#.###.#...#.#..###.#....#.
..#..######.##.#..#.#..#.###....##....#....#
#.#...###..###.##.##.##........#...#.##..#..
##.####.#.###.##......#..##..#....#.#.##....
#.####..####.#....###..##....#..###..###..#.
..##..#.#.###.#..#...#.#.###.....#.###..##..
###.#...##.#####.##.##.#.........##.###...#.
.#.#..##.##...#..###...###.##.###..######.##
.####..#.#.....#######.####..##.####...##...
.#.####.##..#....#.....#.#...........#..#.##
##...#.#....##..#.#.#...##...#####.##.###.##
###.#.##...#..##.####.###.....##..#.#.#..#..
##.##.#..#..###.#........#...##..#..##.#..#.
#....#..#.###...###.###.#.###.#..#.##.##.#.#
##..#..#..#...##.###.#.#.##.##.#.##..#.#.##.
...#.###........#.....###.##..##...##..###.#
###..####....#..##....#...#....#..#.####....
.#...#.##.#.#.###.#.#.##..##..##.#....##..##
#...#...#.##....#....####.#...##.#.#...#....
#.#..##.#.##.##..##...#.#....####.###....###
#.###.#..#.#####.###.##.####...#.#..#...#..#
##.######..#####..####...####...#...#.#..###
..#.#.#.#.#....##.#.##.##.##.......#..#....#
..#..##.#..######.#.#######..####.###.##.#..
.#....#.####...#..#...##..#..#.#....####.##.
#.#.......#..#.##.##..#########.##...#.####.
##..#..##.#.###.#...###....#.##..#.##.....##
##.#.##......##....#.#.##.##..#.#..#...##.##
..#......#.#.#.#####..#.#.#.##..#.##..#.##.#
#....###.#....#..#.....###.###...####..###.#
###..####..#####....###.#####.#..##.#.#.#...
.#.#.##.##.####.##...##...#...#......##...##
.#.#.......#.#######...#.##...#.#..###.####.
##.#.####..#...#.###.##....##.#.##.##...##..
.#......#..##..####..#.##..##..#.#.####.#.##
####.##..###.###....#.##.#.###.#....##..#.#.
.#..##..#..#....#..##..#..#.....#..#######..
.#...#.##.###.##..#.##...#......#.#....##...
..###...#####.#####.#...#..##..#.#.#.###....
