44 44
.##.#.#.#..###...#####.##.#.#..####....#..#.
..#..######.#####.####...#.#...#.##..##..#.#
####..##.####.##.##..##.#.#.####.#####...#.#
##.###.########.##..##.#.#.#####.....##.#.##
..###.#....###.##...###...##....##..#..#.###
#..#.##..#######.###...#..#.##....#.#.#...##
.#..###.####....#..###...#...######......#..
...##..#.##.#..####..#...#.##########..#...#
###.#...#.#..##.#.#.##.#.##.#..#.#####.#..#.
#..#.....##..#..#..#.#.####.##.#.###........
##.####.#.#.#.#.##...#..##.###....#.#...#.#.
.#.#...#.#####..#.#.####....#..##.....###.#.
.###...##..#.###.........#.#...###.#...##.##
#.......#.##......#########...#.....#.....##
.##..#.##...#.#..#.#..####.#.#####.#.##..###
#....###.##..#.#.##.#.#..#..#..#...#.##..#.#
.#..#..#.#######.####.#.####...##...##.#..##
.###....#..#.#.#.#...#...#.##.##.#####.#..##
......##.##.#....###.#..##..##...##.#....###
..##.####..#.#..#.#####..#..#..#.####..###..
##.##.####.....#.#.##..##.....#.##......#.##
.#......####.#.###.#...#..##.##..###........
.##.##.####.##..#....#.#...#.##.#####...###.
.##.######.#######..###.###...#...#####...##
##.##...#....###....#.##.#######..#..##....#
####.#..#..#.#####.#....#.##.##..#..#.#..#.#
#..#.##.##.#..###.###.###.##.##.##.#...#.#.#
#.....###..#.###.#....####.#.#.#.#...#.#.#.#
###...####..#.##...#..#...#...##..#...###..#
...#.##.#.#..#...#..##.###......#.##..#..#..
.#..#.#..##.###.##.#...#..##..###.#.....#..#
####..#######.#.##..#.#..#..###.###.##.#....
###.##...........##....#.#.#.###....##...#..
####.#.#.#...###.....#.#..##....#..#.#.#...#
..#..#.#.##..###.#.##.###.####.#.#....###..#
.....#.###.###...##....#..#...#..###.#.#...#
.#.##.#..#.####..#######..##...####.#..##..#
#..#..#.###.####.#...#..#.##..##.#...##....#
#...#.#.#...##....##.#...######..##..#...##.
#.#.####.#.#.#....#....##.##..#....###...##.
##..#...#####.##..##.....########.#####.#...
.##.##.#..##.##....#.##.......#.########.##.
#.##.##..####.##.##.##.#.##.###.##..#...#.#.
.##.##..##..##.####.###.#.#..#######..##..##
